#######################################
#                 ###                 #
#   ###   #####   ###   #####   ###   #
#                                     #
#   ###   #   ###########   #   ###   #
#         #       ###       #         #
#######   #####   ###   #####   #######
      #   #                 #   #      
      #   #   ###     ###   #   #      
#######   #   #         #   #   #######
#             #         #             #
#######   #   #         #   #   #######
      #   #   ###########   #   #      
      #   #                 #   #      
#######   #   ###########   #   #######
#                 ###                 #
#   ###   #####   ###   #####   ###   #
#     #                         #     #
###   #   #   ###########   #   #   ###
#         #       ###       #         #
#   ###########   ###   ###########   #
#                                     #
#######################################