#####################################
#               ###                 #
# ##### #####   ###   #####   ###   #
#                                   #
#   ### #   ###########   #   ###   #
#       #       ###       #         #
####### #####   ###   #####   #######
####### #                 #   #######
####### #   ###     ###   #   #######
####### #   #         #   #   #######
#           #         #             #
####### #   #         #   #   #######
####### #   ###########   #   #######
####### #                 #   #######
####### #   ###########   #   #######
#               ###                 #
#   ### #####   ###   #####   ###   #
#     #                       #     #
###   # #   ###########   #   #   ###
#       #       ###       #         #
# ###########   ###   ###########   #
#                                   #
#####################################