#######################################
# . . . * . . . . ### . . . . * . . . #
# . ### . ##### . ### . ##### . ### . #
# * . . * . * . * . . * . * . * . . * #
# . ### . # . ########### . # . ### . #
# . . . * # . . . ### . . . # * . . . #
####### . ##### . ### . ##### . #######
      # . # . . * . . * . . # . #      
      # . # . ###-----### . # . #      
####### . # . #---------# . # . #######
# . . . * . * #---------# * . * . . . #
####### . # . #---------# . # . #######
      # . # . ########### . # . #      
      # . # * . . . . . . * # . #      
####### . # . ########### . # . #######
# . . . * . * . . ### . . * . * . . . #
# . ### . ##### . ### . ##### . ### . #
# . . # * . * . * . . * . * . * # . . #
### . # . # . ########### . # . # . ###
# . * . . # . . . ### . . . # . . * . #
# . ########### . ### . ########### . #
# . . . . . . . * . . * . . . . . . . #
#######################################