#######################################
#       .         ###                #
#   ### . #####   ###   #####   ###   #
#       .                             #
#   ### . #   ###########   #   ###   #
#       . #       ###       #         #
####### . #####   ###   #####   #######
      # . #                 #   #      
      # . #   ###-----###   #   #      
####### . #   #---------#   #   #######
#       .     #---------#             #
####### . #   #---------#   #   #######
      # . #   ###########   #   #      
      # . #                 #   #      
####### . #   ###########   #   #######
#       .         ###                 #
#   ### . #####   ###   #####   ###   #
#     # .                       #     #
###   # . #   ###########   #   #   ###
#       . #       ###       #         #
#   ###########   ###   ###########   #
#                                     #
#######################################